14th International Joint Conference on Biomedical Engineering Systems and Technologies 	Proc. 14th Int. Jt. Conf. Biomed. Eng. Syst. Technol.
Acta Crystallographica, Section A: Foundations of Crystallography 	Acta Crystallogr., Sect. A: Found. Crystallogr.
Acta Crystallographica, Section A: Foundations and Advances 	Acta Crystallogr., Sect. A: Found. Adv.
Acta Crystallographica Section D: Biological Crystallography 	Acta Crystallogr., Sect. D: Biol. Crystallogr.
Acta Crystallographica Section D: Structural Biology 	Acta Crystallogr., Sect. D: Struct. Biol.
Acta Crystallographica, Section B: Structural Science, Crystal Engineering and Materials 	Acta Crystallogr., Sect. B: Struct. Sci., Cryst. Eng. Mater.
ACS Chemical Biology 	ACS Chem. Biol.
ACS Catalysis 	ACS Catal.
ACS Central Science 	ACS Cent. Sci.
ACS Omega 	ACS Omega
Accounts of Chemical Research 	Acc. Chem. Res.
Annual Review of Physical Chemistry 	Annu. Rev. Phys. Chem.
Angewandte Chemie, International Edition	Angew. Chem., Int. Ed.
Bioinformatics 	Bioinformatics
Biochemical and Biophysical Research Communications 	Biochem. Biophys. Res. Commun.
Bioconjugate Chemistry 	Bioconjugate Chem.
Bioorganic & Medicinal Chemistry Letters 	Bioorg. Med. Chem. Lett.
BMC Bioinformatics 	BMC Bioinf.
Briefings in Bioinformatics 	Briefings Bioinf.
Cell Research 	Cell Res.
Chemical Reviews 	Chem. Rev.
Chemical Science 	Chem. Sci.
Chemical Society Reviews  	Chem. Soc. Rev.
Chemical Communications 	Chem. Commun
Chemistry & Biology 	Chem. Biol.
Chemistry - A European Journal 	Chem. - Eur. J.
Communications Chemistry 	Commun. Chem.
Current Opinion in Structural Biology 	Curr. Opin. Struct. Biol.
Digital Discovery 	Digital Discovery
European Journal of Biochemistry 	Eur. J. Biochem.
Expert Opinion on Drug Discovery	Expert Opin. Drug Discovery
Frontiers in Chemistry 	Front. Chem.
Frontiers in Molecular Biosciences		Front. Mol. Biosci.
Frontiers in Bioinformatics 	Front. Bioinform.
Frontiers in Genetics 	Front. Genet.
Frontiers in Molecular Biosciences 	Front. Mol. Biosci.
Frontiers in Pharmacology 	Front. Pharmacol.
Fungal Genetics and Biology 	Fungal Genet. Biol.
Information Sciences 	Inf. Sci.
IEEE International Conference on Bioinformatics and Biomedicine 	IEEE Int. Conf. Bioinf. Biomed.
Journal of Applied Crystallography 	J. Appl. Crystallogr.
Journal of Biological Chemistry 	J. Biol. Chem.
Journal of Chemical Information and Modeling 	J. Chem. Inf. Model.
Journal of Cheminformatics 	J. Cheminf.
Journal of Chemical Physics 	J. Chem. Phys.
Journal of Chemical Theory and Computation 	J. Chem. Theory Comput.
Journal of Chemical Education 	J. Chem. Educ.
Journal of Computational Chemistry 	J. Comput. Chem.
Journal of Computer-Aided Molecular Design 	J. Comput.-Aided Mol. Des.
Journal of Inorganic Biochemistry 	J. Inorg. Biochem.
Journal of Medicinal Chemistry 	J. Med. Chem.
Journal of Molecular Biology 	J. Mol. Biol.
Journal of Molecular Structure: THEOCHEM 	J. Mol. Struct.: THEOCHEM
Journal of Natural Products 	J. Nat. Prod.
Journal of Organic Chemistry 	J. Org. Chem.
Journal of Physical Chemistry Letters 	J. Phys. Chem. Lett.
Journal of Physical Chemistry 	J. Phys. Chem.
Journal of Physical Chemistry A 	J. Phys. Chem. A
Journal of Physical Chemistry B 	J. Phys. Chem. B
Journal of Physical Chemistry C 	J. Phys. Chem. C
Journal of the American Chemical Society 	J. Am. Chem. Soc.
Journal of Steroid Biochemistry and Molecular Biology 	J. Steroid Biochem. Mol. Biol.
Journal of Virology 	J. Virol.
Journal of Biomolecular NMR 	J. Biomol. NMR
Journal of Biological Inorganic Chemistry 	J. Biol. Inorg. Chem.
Machine Learning: Science and Technology 	Mach. Learn.: Sci. Technol.
Molecules 	Molecules
Molecular Pharmacology 	Mol. Pharmacol.
Molecular Cell 	Mol. Cell
mAbs 	mAbs
Nature 	Nature
Nature Communications 	Nat. Commun.
Nature Chemistry 	Nat. Chem.
Nature Materials 	Nat. Mater.
Nature Protocols 	Nat. Protoc.
Nature Catalysis 	Nat. Catal. 
Nature Structural & Molecular Biology 	Nat. Struct. Mol. Biol.
Nature Structural Biology 	Nat. Struct. Biol.
Nature Reviews Drug Discovery 	Nat. Rev. Drug Discovery
Nature Reviews Chemistry 	Nat. Rev. Chem.
Nucleic Acids Research 	Nucleic Acids Res.
Organic & Biomolecular Chemistry 	Org. Biomol. Chem.
Physical Chemistry Chemical Physics 	Phys. Chem. Chem. Phys.
Physical Review B 	Phys. Rev. B
Physics Procedia 	Phys. Procedia
Protein & Cell 	Protein Cell
Protein Science 	Protein Sci.
Proteins: Structure, Function, and Bioinformatics 	Proteins: Struct., Funct., Bioinf.
Proteins: Structure, Function, and Genetics 	Proteins: Struct., Funct., Genet.
Procedia Computer Science 	Procedia Comput. Sci.
PLoS One 	PLoS One
PLos Computational Biology 	PLoS Comput. Biol.
Reviews of Modern Physics 	Rev. Mod. Phys.
Science 	Science
Science Advances 	Sci. Adv.
Scientific Reports 	Sci. Rep.
Theoretica Chimica Acta 	Theor. Chim. Acta
Tetrahedron 	Tetrahedron
Tetrahedron Letters 	Tetrahedron Lett.
Topics in Current Chemistry 	Top. Curr. Chem.
Wiley Interdisciplinary Reviews: Computational Molecular Science	 Wiley Interdiscip. Rev.: Comput. Mol. Sci.
Proceedings of the National Academy of Sciences of the United States of America 	Proc. Natl. Acad. Sci. U. S. A.
International Journal of Molecular Sciences 	Int. J. Mol. Sci.
International Journal of Quantum Chemistry 	Int. J. Quantum Chem.
Inorganic Chemistry 	Inorg. Chem.



